70's
The Way We Were - Barbra Streisand
Let It Be - Beatles
Crocodile Rock - Elton John
You're So Vain - Carly Simon
My Love - Paul McCartney
Maggie May - Rod Stewart
How Deep Is Your Love - Bee Gees
American Pie - Don McLean

80's
Against All Odds - Phil Collins
Broken Wings - Mr Mister
Bette Davis Eyes - Kim Carnes
Call Me - Blondie
Say You, Say Me - Lionel Richie
Billie Jean - Michael Jackson
Another One Bites The Dust - Queen
Starting Over - John Lennon
Another Brick In The Wall - Pink Floyd
Total Eclipse Of The Heart - Bonnie Tyler
What's Love Got To Do With It - Tina Turner
I Want To Know What Love Is = Foreigner

90's
I Want It That Way - Backstreet Boys
Baby One More Time - Britney Spears
Truly, Madly, Deeply - Savage Garden
Missing - Everything But The Girl
Because You Loved Me - Celine Dion
I Will Always Love You - Whitney Houston
Everything I Do - Bryan Adams
Save The Best For Last - Vanessa Williams
You Were Meant For Me - Jewel
One Headlight - Wallflowers
I Don't Want To Miss A Thing - Aerosmith

00's
With Arms Wide Open - Creed
I Try - Macy Gray
Complicated - Avril Lavigne
Drops Of Jupiter - Train
Get The Party Started - Pink
Beautiful - Christina Aguilera


